0,0,0,0,0,0,0,0,0,0,0,0,0,0,0,0,0,1,
2,3,9,0,9,0,0,0,0,0,0,0,9,0,3,0,3,9,
1,9,1,0,0,0,0,9,0,4,9,3,0,9,9,3,3,0,
9,1,0,9,0,0,0,4,4,4,4,0,0,3,9,3,9,0,
0,4,0,9,4,6,9,4,7,7,4,0,6,9,0,0,0,0,
0,0,9,0,5,0,0,4,7,7,4,0,5,0,0,9,4,0,
0,9,2,0,0,3,0,4,4,4,4,0,2,0,9,2,0,0,
0,2,0,2,2,7,0,9,9,9,9,0,0,7,0,9,9,0,
9,0,2,9,9,0,0,9,9,4,9,0,0,0,0,0,6,6,
0,1,9,1,9,1,9,1,0,0,0,3,0,0,1,2,0,0,